1111111111
1PB0000FC1
10B0000001
10B00000C1
10B0000001
10B00000C1
10B0000001
10B00000C1
10B0000001
11111111B1
1E00000001
1111111111
