111111111
1000C0001
1P00000E1
100000001
100000001
100000001
100000001
100000001
100000001
100000001
1000F0001
100000001
100000001
111111111
