11111
10011
11111
10001
11111
