1111111
1010001
1011P01
1000001
1111111
