1111111111111
1000000000001
10K0000000001
1000011111001
100001P0000K1
1KKK111111111
1000000000001
1111111111111
