11111
1P011
11111
10001
11111
