1111111111111
1001000000001
10C1000000001
1111011111001
100001P0000C1
1CCC111111111
10000000000E1
1111111111111
