1111111111111
1000000000001
00C0000000001
1000011111001
100001P0000C1
1CCC111111111
10000000000E1
1111111111111
