1111111111111
1000000000001
10C0000000000
1000011111000
100001P0000C1
1CCC111111111
10000000000E1
1111111111111
