1111111111111
1000000000001
1000000000001
1000011111001
100001P000001
1000111111111
10000000000E1
1111111111111
