1111111111111
1000000000001
10C0000000001
1000011111001
100001P0000C1
1CCC111111111
1000000000001
1111111111111
