1111111111111
1000000000001
10C0000000001
1000011111001
10000100000C1
1CCC111111111
10000000000E1
1111111111111
