11111111111
10000000001
10C00000001
1000011100111
100001P0000C1
1CCC111111111
10000000000E1
1111111111111
