1111111111111111111
1C0000F0000000000C1
1111111111101111111
10000000000000000P1
1000000000000000001
1000000000000000001
1000000000000000C01
1000000000000000001
1000000000000000001
1000000000000000001
1E00000000000000001
1111111111111111111
