111111111111111
1P00000C1E1C0F1
111011111011101
10001C001010001
101111101010111
101000001010001
101011101000101
10101C101111101
101010100C1C101
101010101110101
100010000000001
111111111111111
