11111111111
1E100000001
10101011101
100010001P1
11111010111
1C000010001
11111111111
