1111111
1000C01
1010101
1P1E1F1
1111111
