111111111111
100000000001
101111110001
101P0C010001
101111E10001
100001110001
100000000001
111111111111
