111111111111
111000000111
11C000000011
100011111001
10001EP00001
1CCC11111111
1000000000C1
111111111111
