111111111111111111111111
100P1000100000F00C000001
101010101011011111111101
10101010C011010000000001
1010001000110100C0000001
1001111111111000000C0001
1E0000000000C00000000001
111111111111111111111111
