111111111111111111111111
10001000100000000C000001
101010C01011111111111101
10101010101111C000000001
101P001F0011110000000001
100111111111110000000001
1E0000000000C000000000C1
111111111111111111111111
