111111111111
1E0000000001
111111101111
100C000000C1
101011101101
10101F101101
1P10001C0001
111111111111
