111111111111
1P0000000001
1011111111E1
100C00000111
1011101001F1
101110100101
100C00100C01
111111111111
