111111111111
1C00001F00C1
1011101111P1
100000000001
11111B111111
1C0000000C01
100C0E0C0001
111111111111
