111111111111
1C00001F00C1
1011101111P1
100000000001
11111B111111
1C00000000C1
100C00E0C001
111111111111
