111111111111
1BBBBBBBBBB1
101000000001
101000000001
101000000001
1F1000C00001
1E000CPC0001
111111111111
