111111111111
10BBBBBBBBB1
10B00C000001
10B0000C0001
10BF00000E01
10B0000C0001
1PB00C000001
111111111111
