1111111111111111111111
1111111111111111111111
10000000000CF000000001
1000000000011111C111B1
100P0000000111111111B1
1000000000000000000001
1E11111111111111111111
1111111111111111111111
