1111111111111111111111
1111111111111111111111
100000000FC00000000001
1B111C1111100000000001
1B11111111100000000P01
1000000000000000000001
11111111111111111111E1
1111111111111111111111
