111111111111
100000000001
100000000001
100U00000001
100000000001
100000000001
100000000001
100000000001
100000000001
10000000E001
111111110111
100000010101
100000010101
100000010101
10000001A101
100000010101
100000010101
100000010101
11111111B111
1000000001F1
101C1C11C101
101111111101
1000000000C1
101111111B01
1000000000P1
111111111111
