111111111111
100000000001
100000000001
100U00000001
100000000001
100000000001
100000000001
100000000001
100000000001
1000000000E1
1111111111B1
1000000001B1
1000000001B1
1000000001B1
1000000001A1
1000000001B1
1000000001B1
1000000001B1
1111111111B1
100000000001
1011C1C1C111
101111111111
1F00C0000001
1C1111111B01
1000000000P1
111111111111
