111111111111
10000001E101
100000010101
100000010101
100000010101
100000010101
100000010101
100000010101
100000010101
111111110111
1000000001F1
101C1C1C0101
101111111101
1000000000C1
101111111B01
1P0000000001
111111111111
