111111111
1FBPCCCE1
111111111
